var aldenb3_maptext = {
"map":[
"############################################################################################################",
"#############################~~~~~####################################~~~~~#########################..##...#",
"###########################;;~~~~~;;################################;;~~~~~;;#######################.#.###.#",
"##########################.;;;;;;;;;.##############################;;...B..;;;######################..###..#",
"#########################...;;;;;;;...############################;;;........;;#####################.#.###.#",
"########################..==...;;;;==..##########################;;==.......==;;####################..##...#",
"#######################...==;...;;;==...########################;;;==.......==;;;###########################",
"#######################.B.....;.;;;;....########################;;.............;;###########################",
"######################......;....;;......#.******************.#;;....;;....;;;;.;;##########################",
"######################..;.....;..........#....................#;;...;;.....;;;;.;;##########################",
"######################.....;.;;;.;..;...._....................G;;..;;;..........;;##########################",
"######################.......;;;.........#.....H..............#;;..;;;;.........;;##########################",
"######################....;..;;;..;......#.******************.#;;....;;...;;;...;;##########################",
"#######################.C.....;;;.......########################;....;;...;;;;.;;###########################",
"#######################...==;.;;;.;==...########################;;.==.....;;==.;;###########################",
"########################..==..;;;..==..##########################;;==.....;;==;;############################",
"#########################....;;;;;;...############################;;........;;;#############################",
"##########################.;;;;;;;;;.##############################;;;;....;;;##############################",
"###########################;;~~~~~;;################################;;;;;;;;;###############################",
"#############################~~~~~####################################;;;;;#################################",
"###############################G########################################_###################################",
"#############################.....####################################.....#################################",
"#############################*...*####################################*...*#################################",
"#############################*...*####################################*...*#################################",
"#############################*...*####################################*...*#################################",
"#############################*...*####################################*..E*#################################",
"#############################*...*####################################*...*#################################",
"#############################*...*####################################*...*#################################",
"#############################*...*####################################*...*#################################",
"#############################*I..*####################################*...*#################################",
"#############################*...*####################################*...*#################################",
"#############################*...*####################################*...*#################################",
"#############################*...*####################################*...*#################################",
"#############################*...*####################################*...*#################################",
"#############################*...*####################################*...*#################################",
"#############################*...*####################################*...*#################################",
"#############################*...*####################################*...*#################################",
"#############################.....####################################.....#################################",
"###############################_########################################_###################################",
"#############################~~~~~#####################################...#####...##########################",
"###########################;;~~~~~;;##################################.....###.....#########################",
"##########################;;;;;;;;;;;#############################..#..*.*..#.......########################",
"#########################;;;;;;;;;;;;;###########################...G..*A*.._...+...########################",
"########################;;==;;;;;;;==;;#########################....#..***..#.......########################",
"#######################;;;==;;;;;;;==;;;########################...###.....###.....#########################",
"#######################;;;;;;..;;;;;;;;;########################...####...#####...##########################",
"######################;;;;;;....;;;;;;;;;#.******************.##...#########################################",
"######################;;;;;;....;;;;;;;;;#.....K..............#....#########################################",
"######################;;;;;;;..;;;;;;;;;;G..............*J...._..F##########################################",
"######################;;;;;;;;;;;;;;;;;;;#....................#..###########################################",
"######################;;;;;;;;;;;;;;;;;;;#.******************.##############################################",
"#######################;;;;;;;;;;;;;;;;;####################################################################",
"#######################;;;==;;;;;;;==;;;####################################################################",
"########################;;==;;;;;;;==;;#####################################################################",
"#########################;;;;;;;;;;;;;######################################################################",
"##########################;;C;;B;;C;;#######################################################################",
"###########################;;;;;;;;;########################################################################",
"#############################;;;;;##########################################################################",
"############################################################################################################",
"############################################################################################################",
"############################################################################################################"

]
,"properties":{"title":"Alden House B3",
"tileset":"fireDungeon",
"fillerTile":"#",
"top":0,
"left":0,
"bottom":0,
"right":0},
"errors":[],"objects":{"A":{"tile":"A",
"type":"exit",
"name":"aldenb3",
"to":"aldenb2",
"at":"aldenb3"},"B":{"tile":"B",
"type":"enemy",
"name":"flamethrower-wielding cultist",
"attack":35,"health":150,"range":5,"flamethrower":"true",
"letter":"F",
"boss":"yes",
"drop":"F"},"C":{"tile":"C",
"type":"enemy",
"name":"flamethrower-wielding cultist",
"attack":35,"health":150,"range":5,"flamethrower":"true",
"letter":"F",
"boss":"yes"},"D":{"tile":"D",
"type":"enemy",
"name":"oil drum",
"explodes":"true",
"movement":"none",
"attack":0,"health":10,"letter":"D",
"onTile":";"},"E":{"tile":"E",
"type":"item",
"name":"journal labeled \"1988\"",
"description":"A dusty, dark old tome. An excerpt: \"...and so I conclude (admit, even) that our efforts below the West Tower have failed. Though we've reached considerable depths, the tower, it seems, reaches deeper. The soil grows rockier every inch, and huge boulders that cannot be displaced impede our effort for weeks as we attempt to dig around them. The East Tower, being in the water, may be more viable, despite the obvious challenges digging underwater...\""},"F":{"tile":"F",
"type":"item",
"name":"black key",
"description":"A black metal key that sits heavy in your hand."},"G":{"tile":"G",
"type":"door",
"key":"black key"},"H":{"tile":"H",
"type":"item",
"name":"journal labeled \"1989\"",
"description":"A dusty, dark old tome. An excerpt: \"All of Flauston seems to lack the quantity of explosives we require, no matter how many warehouses we rob. Our efforts making our own are successful enough, but limited, and time-consuming. To topple a tower requires more, much more.\""},"I":{"tile":"I",
"type":"item",
"name":"journal labeled \"1990\"",
"description":"A dusty, dark tome. An excerpt: \"The police are all but in our pockets now. Progress has sped along neatly as a result. We practically rule this city already! But the time to reveal ourselves has not yet come. When we rise from the ashes in the east, and reveal our name, there can be no doubt as to our power and the propriety of our new position of leadership in Flauston.\""},"J":{"tile":"J",
"type":"npc",
"name":"The Librarian",
"dialog":["- Hmm?",
"== [plotCheckNegative:saveEastSide;ongoing] I'm $firstName $lastName.",
"--- Oh! I've heard about you! They said you'd be coming, but I didn't believe you'd make it all the way down here...",
"==== Who are you?",
"----- I'm the librarian... I keep tabs on all of the Watch's literature.",
"====== I want to ask you some questions.",
"------- If you want to know about First Watch, everything you could possibly want to know is in the books here.",
"------- I'll give you free access to the books if you, in exchange, leave me to my writing. There is so much to write down...",
"======== I'll leave you alone if you tell me where your leader is.",
"--------- The Keeper? He left... for the East Tower. They intend to destroy it.",
"--------- Many will die, sadly. The explosion is arranged such that the tower will fall on the East Side.",
"--------- As a result, however, our dominance over the city will be irrefutable.",
"========== I am going to stop this \"Keeper\".",
"----------- I doubt it... the East Side will be completely blocked off by now.",
"----------- If you want to join those who are trapped there to die, very well. A fitting end for you, I'd say!",
"----------- [plotSet:saveEastSide;ongoing]",
"----------- [newObjective:Stop First Watch from destroying the East Tower.]",
"== [logic:else] I don't have time to talk."]},"K":{"tile":"K",
"type":"item",
"name":"journal labeled \"1991\"",
"description":"A dark tome. An excerpt: \"The stranger knows too much! I don't understand it. Now, when we're so close to our greatest achievement, this nobody is picking off our best, one by one, and they're headed this way. I fear they may even be able to infiltrate this safehouse. Well, no reason to take risks. I'll be moving to the East Tower immediately. Even if we have to accelerate our plans, we can't fail now!\""}}}