var easttower_maptext = {
"map":[
"`````````````````````````````````````````````````````````````````````````````````````````````````````````````````````````````````````````````````````````",
"`````````````````````````````````````````````````````````````````````````````=================``````````````````````````````````````````",
"`````````````````````````````````````````````````````````````````````````========================```````````````````````````````````````",
"```````````````````````````````````````````````````````````````````````=============================````````````````````````````````````",
"`````````````````````````````````````````````````````````````````````=================================``````````````````````````````````",
"```````````````````````````````````````````````````````````````````=====================================````````````````````````````````",
"``````````````````````````````````````````````````````````````````=======================================```````````````````````````````",
"````````````````````````````````````````````````````````````````==========================================``````````````````````````````",
"```````````````````````````````````````````````````````````````=============================================````````````````````````````",
"``````````````````````````````````````````````````````````````===============================================```````````````````````````",
"`````````````````````````````````````````````````````````````=================================================``````````````````````````",
"````````````````````````````````````````````````````````````===================================================`````````````````````````",
"```````````````````````````````````````````````````````````=====================================================````````````````````````",
"``````````````````````````````````````````````````````````=======================================================```````````````````````",
"`````````````````````````````````````````````````````````========================================================```````````````````````",
"````````````````````````````````````````````````````````==========================================================```````````````*```````````````````````",
"````````````````````````````````````````````````````````===========================================================`````````````***``````````````````````",
"```````````````````````````````````````````````````````============================================================`````````````***``````````````````````",
"```````````````````````````````````````````````````````=============================================================```````````*****`````````````````````",
"``````````````````````````````````````````````````````===============================================================``````````*****`````````````````````",
"``````````````````````````````````````````````````````===============================================================`````````**...**````````````````````",
"`````````````````````````````````````````````````````================================================================`````````*.....*````````````````````",
"`````````````````````````````````````````````````````=================================================================```````**..D..**```````````````````",
"`````````````````````````````````````````````````````=================================================================```````*.......*```````````````````",
"````````````````````````````````````````````````````==================================================================``````**.......**``````````````````",
"````````````````````````````````````````````````````===================================================================`````*.........*``````````````````",
"````````````````````````````````````````````````````===================================================================`````*.........*``````````````````",
"````````````````````````````````````````````````````===================================================================````**.........**`````````````````",
"```````````````````````````````````````````````````====================================================================````*...........*`````````````````",
"```````````````````````````````````````````````````=====================================================================```*...........*`````````````````",
"```````````````````````````````````````````````````=====================================================================```*..,,...,,..*`````````````````",
"```````````````````````````````````````````````````=====================================================================```*..,,...,,..*`````````````````",
"```````````````````````````````````````````````````=====================================================================```*..,,...,,..*`````````````````",
"```````````````````````````````````````````````````=====================================================================```*..,,...,,..*`````````````````",
"```````````````````````````````````````````````````=====================================================================```*..,,...,,..*`````````````````",
",,,,,,,,,,,,,,,,,,,,,,,,,,,,,,,,,,,,,,,,,,,,,,,,,,,=====================================================================```*..,,...,,..*`````````````````",
",,,,,,,,,,,,,,,,,,,,A,+,,,,,,,,,,,,,,,,,,,,,,,,,,,,=====================================================================```*..,,...,,..*`````````````````",
",,,,,,,,,,,,,,,,,,,,,,,,,,,,,,,,,,,,,,,,,,,,,,,,,,,=====================================================================```*..,,...,,..*`````````````````",
"````````````````````````````````````````````````,,,=====================================================================```*..,,...,,..*`````````````````",
"````````````````````````````````````````````````,,,=====================================================================```*..,,...,,..*`````````````````",
"````````````````````````````````````````````````,,,=====================================================================```*...........*`````````````````",
"````````````````````````````````````````````````,,,====================================================================````*...........*`````````````````",
"`````````````````````````````````````````````````,,,===================================================================````*##''####C##*`````````````````",
"`````````````````````````````````````````````````,,,===================================================================````*#.**.#....#*`````````````````",
"`````````````````````````````````````````````````,,,===================================================================````*#....#.**.#*`````````````````",
"`````````````````````````````````````````````````,,,==================================================================`````*#....#.**.#*,,,,,,```````````",
"``````````````````````````````````````````````````,,,=================================================================`````*#...._.**.G,,,,,,,```````````",
"``````````````````````````````````````````````````,,,=================================================================`````*#....#....#*,,,,,,```````````",
"``````````````````````````````````````````````````,,,================================================================``````*#######_###*```,,,```````````",
"```````````````````````````````````````````````````,,,===============================================================``````**##B....##**```,,,```````````",
"```````````````````````````````````````````````````,,,===============================================================```````**#######**````,,,```````````",
"````````````````````````````````````````````````````,,,=============================================================`````````**#####**`````,,,```````````",
"````````````````````````````````````````````````````,,,============================================================```````````**###**``````,,,```````````",
"`````````````````````````````````````````````````````,,,===========================================================````````````*****```````,,,```````````",
"``````````````````````````````````````````````````````,,,=========================================================`````````````````````````,,,```````````",
"``````````````````````````````````````````````````````,,,,=======================================================``````````````````````````,,,```````````",
"```````````````````````````````````````````````````````,,,======================================================```````````````````````````,,,```````````",
"````````````````````````````````````````````````````````,,,=====================================================```````````````````````````,,,```````````",
"````````````````````````````````````````````````````````,,,,===================================================````````````````````````````,,,```````````",
"`````````````````````````````````````````````````````````,,,,=================================================`````````````````````````````,,,```````````",
"``````````````````````````````````````````````````````````,,,,===============================================``````````````````````````````,,,```````````",
"```````````````````````````````````````````````````````````,,,,=============================================```````````````````````````````,,,```````````",
"````````````````````````````````````````````````````````````,,,,==========================================`````````````````````````````````,,,```````````",
"`````````````````````````````````````````````````````````````,,,,,=======================================``````````````````````````````````,,,```````````",
"``````````````````````````````````````````````````````````````,,,,,====================================````````````````````````````````````,,,```````````",
"````````````````````````````````````````````````````````````````,,,,,=================================`````````````````````````````````````,,,```````````",
"`````````````````````````````````````````````````````````````````,,,,,,============================````````````````````````````````````````,,,```````````",
"```````````````````````````````````````````````````````````````````,,,,,,========================``````````````````````````````````````````,,,```````````",
"`````````````````````````````````````````````````````````````````````,,,,,,,,=================`````````````````````````````````````````````,,,```````````",
"```````````````````````````````````````````````````````````````````````,,,,,,,,,,,,,,,,,,,,,,,,,,,,,,,,,,,,,,,,,,,,,,,,,,,,,,,,,,,,,,,,,,,,,,,```````````",
"`````````````````````````````````````````````````````````````````````````,,,,,,,,,,,,,,,,,,,,,,,,,,,,,,,,,,,,,,,,,,,,,,,,,,,,,,,,,,,,,,,,,,,,,```````````",
"`````````````````````````````````````````````````````````````````````````````,,,,,,,,,,,,,,,,,,,,,,,,,,,,,,,,,,,,,,,,,,,,,,,,,,,,,,,,,,,,,,,,,```````````",
"`````````````````````````````````````````````````````````````````````````````````````````````````````````````````````````````````````````````````````````"]
,"properties":{"title":"Flauston Bay",
"tileset":"darkcity",
"fillerTile":"`",
"top":0,
"left":20,
"bottom":0,
"right":0},
"errors":[],"objects":{
"A":{"tile":"A",
"type":"exit",
"name":"eastTower",
"to":"eastsidehell",
"at":"eastTower",
"furthest":"west"},
"B":{"tile":"B",
"type":"exit",
"name":"endingBoat",
"to":"endingBoat",
"at":"endingBoat"},
"C":{"tile":"C",
"type":"door",
"key":"key with a gold inlay"},
"D":{"tile":"D",
"type":"npc",
"name":"a black-robed figure",
"dialog":["- So you made it.",
"== I assume you're the Keeper?",
"--- So I am called. And you're this... stranger. I've heard so much about you.",
"==== I'm here to stop you.",
"----- I'm aware. But it's too late. I have the detonator in my hand.",
"----- Which of us will prevail in combat, I wonder?",
"----- It is merely an academic exercise. I will denote the explosives if you strike me down.",
"----- So, as our final act on this earth, let us have a deadly last dance.",
"----- [transform:D;E]"]},"E":{"tile":"E",
"type":"enemy",
"name":"The Keeper",
"attack":100,"health":200,"range":12,"letter":"X",
"onDeathTransform":"F",
"shortRangeSpecial":"slices you with an offhand sword!",
"rushIfClose":"true",
"boss":"true"},
"F":{"tile":"F",
"type":"npc",
"name":"The Keeper",
"dialog":["- So... you are as tough as they say... heh...",
"== You don't have to die here. Hand over the detonator.",
"--- I'm afraid I won't. Though the explosion will kill us both, First Watch's glory will be irrefutable.",
"--- My sacrifice will carry on into eternity... and you will be forgotten.",
"--- Goodbye, stranger...",
"--- [teleport:endgame;19;15]"]},"G":{"tile":"G",
"type":"door",
"oneWay":"west"}}}