var endingboat_maptext = {
"map":[
"```````*```````````````````````",
"``````***``````````````````````",
"``````***``````````````````````",
"`````*****`````````````````````",
"`````*****`````````````````````",
"````**###**````````````````````",
"````*#####*````````````````````",
"```**##C##**```````````````````",
"```*###C###*```````````````````",
"``**##CCC##**``````````````````",
"``*###CCC###*``````````````````",
"``*##CCCCC##*``````````````````",
"`**##CCCCC##**`````````````````",
"`*##.....CC##*`````````````````",
"`*##B.....C##*`````````````````",
"`*##......C##*`````````````````",
"`*##CCC...C##*`````````````````",
"`*##CCC...C##*`````````````````",
"`*##CCC...C##*`````````````````",
"`*##CCC...C##*`````````````````",
"`*##CCC...C##*`````````````````",
"`*##CC....C##*`````````````````",
"`*######.####*`````````````````",
"`*##CC....C##*`````````````````",
"`*##CCC...C##*`````````````````",
"`*##CCC...C##*`````````````````",
"`*##CCC...C##*`````````````````",
"`*##CCC...C##*`````````````````",
"`*##CCC...C##*`````````````````",
"`*##CCC...C##*`````````````````",
"`*##CCC...C##*,,,,,,```````````",
"`*##CCC...C##,,,,,,,```````````",
"`*##CCC....##*,,,,,,```````````",
"`*#######_###*```,,,```````````",
"`**##A....##**```,,,```````````",
"``**#######**````,,,```````````",
"```**#####**`````,,,```````````",
"````**###**``````,,,```````````",
"`````*****```````,,,```````````"
],"properties":{"title":"Below Deck",
"tileset":"darkcity",
"fillerTile":"`",
"top":0,
"left":0,
"bottom":0,
"right":0},
"errors":[],"objects":{
"A":{"tile":"A",
"type":"exit",
"name":"endingBoat",
"to":"easttower",
"at":"endingBoat"},
"B":{"tile":"B",
"type":"item",
"name":"key with a gold inlay",
"description":"This silver key has a circular gold inlay which is embossed depicting a wide-eyed skull."},"C":{"tile":"C",
"type":"enemy",
"name":"bundle of explosives",
"movement":"none",
"attack":0,"health":999,"letter":"E",
"invulnerable":"true"}}}