var underpassHeader_maptext = {
"map":[
"######################################",
"#.#.#.##.#..##...#..##..##..###..##..#",
"#.#.#..#.#.#.#.###.#.#.#.#.#.#.###.###",
"#.#.#.#..#.#.#..##..##..##...#...#...#",
"#.#.#.##.#.#.#.###.#.#.###.#.###.###.#",
"#...#.##.#..##...#.#.#.###.#.#...#...#",
"######################################"
],"properties":{"title":"Underpass",
"tileset":"darkcity",
"fillerTile":"#",
"top":0,
"left":0,
"bottom":0,
"right":0}} ;